Cell	cell_type
CGTACTC_AGTC_7	NP+DE
ACAATCG_AGTC_7	DE+DE
AGATGCG_AGTC_7	NP+DE
AGTACCT_AGTC_7	NP+DE
GCATCGT_AGTC_7	DE+DE
CATGTGC_AGTC_7	DE+DE
GCATACT_AGTC_7	NP+DE
CATTGGA_AGTC_7	DE+DE
GGTGATC_AGTC_7	DE+EmVE
TACCAGT_AGTC_7	DE+DE
CTTGCAG_AGTC_7	DE+DE
ACCGATC_AGTC_7	DE+DE
CGGATTA_AGTC_7	NP+DE
GGAGACT_AGTC_7	DE+ExVE
ATGCCAA_AGTC_7	DE+DE
TCTCGAA_AGTC_7	DE+EmVE
TGCCTAA_AGTC_7	DE+DE
AAGGTAC_AGTC_7	DE+DE
TATAGGC_AGTC_7	DE+DE
CTAAGCG_AGTC_7	DE+EmVE
TACGAGG_AGTC_7	DE+DE
TACGTAC_AGTC_7	DE+DE
ATAACCG_AGTC_7	DE+DE
GCCTACA_AGTC_7	DE+DE
AACGGTG_AGTC_7	DE+DE
AACTCGT_AGTC_7	DE+DE
ACGATGC_CATG_7	DE+ExVE
GTTACCT_CATG_7	DE+DE
AGTCGAC_CATG_7	DE+DE
CGATATC_CATG_7	DE+EmVE
GCATACT_CATG_7	NP+DE
CTTGTAC_CATG_7	DE+ExVE
AACATCG_CATG_7	DE+DE
GAGATCG_CATG_7	DE+EmVE
CATGGAT_CATG_7	DE+ExVE
ATGACGT_CATG_7	NP+DE
ATAGGTC_CATG_7	DE+EmVE
ATCTACG_CATG_7	DE+DE
CTCATGA_CATG_7	DE+ExVE
GCTGACA_CATG_7	NP+DE
GCATGGA_CATG_7	DE+EmVE
CAGCGTA_CATG_7	DE+EmVE
CGAAGGT_CATG_7	DE+EmVE
ACAGGTA_CATG_7	DE+DE
GTTGACT_CATG_7	DE+DE
TCTTCGA_CATG_7	NP+DE
TACCAGT_CATG_7	DE+DE
CTTGCAG_CATG_7	DE+DE
CGTCAGA_CATG_7	DE+EmVE
AGCACTG_CATG_7	NP+DE
TGCACAA_CATG_7	DE+DE
GGAGACT_CATG_7	NP+DE
ACTGCAG_CATG_7	DE+DE
TGCCTAA_CATG_7	DE+DE
ACTTGGC_CATG_7	DE+DE
CTAAGCG_CATG_7	DE+DE
AACAGCT_CATG_7	DE+DE
TACGAGG_CATG_7	DE+DE
TCGATAC_CATG_7	DE+DE
TCTGGAG_CATG_7	NP+DE
ATAACCG_CATG_7	NP+DE
TAGCGCA_CATG_7	DE+ExVE
CTACAAG_CATG_7	NP+DE
AACGGTG_CATG_7	DE+DE
TGACGGA_CATG_7	DE+DE
GGTTCAA_TTGG_8	DE+EmVE
CTGGAAG_TTGG_8	NP+DE
CAGGAAT_TTGG_8	DE+DE
ATAGCCT_TTGG_8	DE+DE
GACCTGT_TTGG_8	DE+ExVE
TACCGAT_TTGG_8	DE+DE
GTCACAC_TTGG_8	DE+DE
CACAGTA_TTGG_8	DE+DE
GTCGAGA_TTGG_8	NP+DE
GACTGTG_TTGG_8	DE+EmVE
CGTACTC_TTGG_8	DE+EmVE
AGTCGAC_TTGG_8	NP+DE
CGATATC_TTGG_8	DE+DE
AGCAGGT_TTGG_8	DE+DE
GAGATCG_TTGG_8	DE+ExVE
CATTGGA_TTGG_8	DE+DE
TAGACCA_TTGG_8	DE+ExVE
ATAGGTC_TTGG_8	DE+DE
ATCTACG_TTGG_8	DE+DE
CTCATGA_TTGG_8	DE+ExVE
TAGGCAT_TTGG_8	NP+DE
ATGGCTC_TTGG_8	DE+DE
TGTCACG_TTGG_8	NP+DE
CTTAGTG_TTGG_8	DE+ExVE
ATCTGCA_TTGG_8	DE+DE
GATCACA_TTGG_8	NP+DE
ACACGTG_TTGG_8	DE+DE
GCAGTAG_TTGG_8	DE+ExVE
CTAGTGC_TTGG_8	DE+EmVE
TTGCCAG_TTGG_8	NP+DE
TTGCAGA_TTGG_8	DE+DE
CGAGTCT_TTGG_8	DE+DE
CGTTGAA_TTGG_8	DE+DE
ACCGATC_TTGG_8	DE+EmVE
CGGATTA_TTGG_8	DE+ExVE
CGTCAGA_TTGG_8	DE+DE
CTACGTA_TTGG_8	DE+DE
TCGACTC_TTGG_8	DE+DE
AGTGCGT_TTGG_8	NP+DE
CGTAACT_TTGG_8	DE+EmVE
AGCTAGT_TTGG_8	NP+DE
ATAGCGA_TTGG_8	NP+DE
TATAGGC_TTGG_8	NP+DE
ACGCTAT_TTGG_8	DE+ExVE
CCTGACT_TTGG_8	NP+DE
AACAGCT_TTGG_8	DE+DE
AGAGCAT_ACAG_8	DE+DE
TATGTCC_ACAG_8	DE+DE
TCAGCCT_ACAG_8	NP+DE
CAGGAAT_ACAG_8	NP+DE
TGCTGAG_ACAG_8	NP+DE
TACCGAT_ACAG_8	NP+DE
ACGCTTC_ACAG_8	DE+DE
ACGTTGG_ACAG_8	DE+DE
AATGCCG_ACAG_8	DE+DE
GCATCCA_ACAG_8	DE+DE
TCTAACG_ACAG_8	DE+DE
GACTGTG_ACAG_8	DE+ExVE
ACAATCG_ACAG_8	DE+DE
TGATGAC_ACAG_8	DE+DE
AGTCGAC_ACAG_8	DE+ExVE
GCATACT_ACAG_8	NP+DE
CATTGGA_ACAG_8	DE+DE
ATCTACG_ACAG_8	DE+DE
GTTAGGC_ACAG_8	DE+DE
CCATTGC_ACAG_8	DE+EmVE
CTCATGA_ACAG_8	DE+ExVE
ATTCCGT_ACAG_8	DE+DE
GGAACCT_ACAG_8	NP+DE
GTATGCG_ACAG_8	DE+DE
CCTAAGG_ACAG_8	DE+DE
CGCTTGA_ACAG_8	NP+DE
TGGAGCA_ACAG_8	DE+DE
GCTTCAT_ACAG_8	DE+ExVE
GGCGATT_ACAG_8	NP+DE
GGCTAGA_ACAG_8	DE+EmVE
CAATCGA_ACAG_8	DE+DE
GCTGAAT_ACAG_8	DE+DE
TTGCAGA_ACAG_8	DE+DE
GAATAGC_ACAG_8	DE+DE
CAGTCAA_ACAG_8	DE+ExVE
ATGCCAA_ACAG_8	DE+DE
CTACGTA_ACAG_8	DE+DE
TGCCTAA_ACAG_8	DE+DE
CTTACGG_ACAG_8	DE+DE
ACGCTAT_ACAG_8	NP+DE
TACGAGG_ACAG_8	NP+DE
CTTGTAC_AGTC_33	DE+DE
AGTCGAC_CATG_33	NP+DE
AGATCAC_CATG_33	DE+DE
GGTCTTA_AGTC_3	NP+DE
GGTTCAA_AGTC_3	DE+DE
CTGGAAG_AGTC_3	DE+ExVE
GCATCAG_AGTC_3	DE+DE
GTAATCC_AGTC_3	DE+DE
GGACTTC_AGTC_3	DE+DE
CGGTCTA_AGTC_3	DE+ExVE
ATAGCCT_AGTC_3	DE+DE
GCCATTC_AGTC_3	DE+EmVE
TGAGCAG_AGTC_3	DE+EmVE
GTAACGT_AGTC_3	DE+ExVE
CATGAGG_AGTC_3	NP+DE
AATGCCG_AGTC_3	DE+DE
TTCAGTC_AGTC_3	DE+DE
TGGACAC_AGTC_3	DE+DE
TGGAGCA_AGTC_3	NP+DE
CCTGATG_AGTC_3	DE+DE
ATCTGCA_AGTC_3	DE+DE
CTGTGAG_AGTC_3	DE+ExVE
GGCTAGA_AGTC_3	DE+DE
GACACTG_AGTC_3	NP+DE
TACGACT_CATG_3	DE+ExVE
GTAATCC_CATG_3	NP+DE
TCAGCCT_CATG_3	DE+DE
GGACTTC_CATG_3	NP+DE
CAAGGTT_CATG_3	NP+DE
ATAGCCT_CATG_3	DE+DE
CACAGTA_CATG_3	DE+EmVE
GCTCATA_CATG_3	NP+DE
ACTGTCC_CATG_3	DE+ExVE
CATGAGG_CATG_3	DE+DE
ACGTTGG_CATG_3	DE+DE
TTCCTGA_CATG_3	DE+EmVE
CTGTGAG_CATG_3	DE+ExVE
GGCTAGA_CATG_3	NP+DE
CACGAGT_AGTC_3	NP+DE
ACGATGC_AGTC_3	DE+DE
CGATATC_AGTC_3	DE+EmVE
AGCAGGT_AGTC_3	DE+ExVE
GCATACT_AGTC_3	DE+DE
TGAGACC_AGTC_3	DE+DE
GTAAGTC_AGTC_3	DE+DE
CATTGTC_AGTC_3	NP+DE
CTGTATG_AGTC_3	NP+DE
TCGTGAG_AGTC_3	NP+DE
CATTGGA_AGTC_3	DE+EmVE
ATAGGTC_AGTC_3	DE+DE
GCTGACA_AGTC_3	DE+EmVE
GGAACCT_AGTC_3	DE+DE
TAGGCAT_AGTC_3	DE+ExVE
GGTGATC_AGTC_3	NP+DE
CAGCGTA_AGTC_3	DE+DE
ACAGGTA_AGTC_3	DE+DE
GCTGAAT_AGTC_3	DE+DE
CTAGTGC_AGTC_3	DE+DE
GCAACTA_AGTC_3	DE+EmVE
TTGCAGA_AGTC_3	DE+DE
CTTGCAG_AGTC_3	DE+DE
CGGATTA_AGTC_3	NP+DE
CAGTCAA_AGTC_3	DE+DE
ATGCCAA_AGTC_3	DE+DE
CGCTACA_AGTC_3	DE+DE
CGTAACT_AGTC_3	NP+DE
CTTACGG_AGTC_3	DE+ExVE
CATGCTG_AGTC_3	NP+DE
CCATGGT_AGTC_3	DE+DE
CGCATAT_AGTC_3	DE+DE
TCTGGAG_AGTC_3	DE+EmVE
TCTTAGG_CATG_3	DE+DE
CACGAGT_CATG_3	DE+DE
CGTACTC_CATG_3	DE+DE
ACGATGC_CATG_3	DE+DE
TGATGAC_CATG_3	DE+DE
CGATATC_CATG_3	DE+DE
GCATCGT_CATG_3	DE+ExVE
AGCAGGT_CATG_3	DE+DE
ATGACGT_CATG_3	DE+DE
GGTCCAT_CATG_3	DE+EmVE
GTTAGGC_CATG_3	DE+DE
GCATGGA_CATG_3	DE+DE
CATACAG_CATG_3	DE+ExVE
CGAAGGT_CATG_3	DE+DE
GTTGACT_CATG_3	DE+DE
CAATGCG_CATG_3	DE+DE
GCAACTA_CATG_3	DE+DE
ATCAGGC_CATG_3	DE+DE
CGAGTCT_CATG_3	NP+DE
CTTCGAA_CATG_3	DE+EmVE
CAGTACG_CATG_3	DE+ExVE
AGGCTAG_CATG_3	NP+DE
CAGTCAA_CATG_3	DE+DE
AGCACTG_CATG_3	DE+DE
GGAGACT_CATG_3	DE+DE
ACTGCAG_CATG_3	DE+ExVE
CTACGTA_CATG_3	DE+ExVE
TCTCGAA_CATG_3	DE+DE
GCTTAGA_CATG_3	DE+DE
ACGCTAT_CATG_3	DE+DE
CCTGACT_CATG_3	DE+DE
CGCATAT_CATG_3	DE+DE
AAGCCTT_CATG_3	DE+EmVE
AACAGCT_CATG_3	DE+DE
GCATCAG_TTGG_2	DE+DE
TACGACT_TTGG_2	NP+DE
TATGTCC_TTGG_2	DE+DE
GTAATCC_TTGG_2	DE+DE
GGACTTC_TTGG_2	DE+ExVE
TGCTGAG_TTGG_2	DE+DE
TACCGAT_TTGG_2	DE+DE
GCCATTC_TTGG_2	DE+DE
ACGCTTC_TTGG_2	DE+ExVE
ACTGTCC_TTGG_2	NP+DE
GTAACGT_TTGG_2	NP+DE
CATGAGG_TTGG_2	DE+ExVE
GACTGTG_TTGG_2	DE+DE
CGTACTC_TTGG_2	DE+DE
CGATATC_TTGG_2	DE+EmVE
CATGTGC_TTGG_2	NP+DE
CTGTATG_TTGG_2	DE+DE
ATAGGTC_TTGG_2	DE+EmVE
CCATTGC_TTGG_2	NP+DE
ATGGCTC_TTGG_2	NP+DE
TGCTACT_TTGG_2	DE+ExVE
CTATTCG_TTGG_2	DE+DE
CTTAGTG_TTGG_2	NP+DE
GGCTAGA_TTGG_2	DE+DE
CACAGAT_TTGG_2	DE+DE
GCAGTAG_TTGG_2	NP+DE
CAGTACG_TTGG_2	NP+DE
TACCAGT_TTGG_2	NP+DE
CTTGCAG_TTGG_2	DE+ExVE
ACCGATC_TTGG_2	DE+ExVE
CTACGTA_TTGG_2	DE+DE
AGTGCGT_TTGG_2	NP+DE
CTTACGG_TTGG_2	DE+DE
CCTGACT_TTGG_2	DE+EmVE
TACGAGG_TTGG_2	DE+ExVE
TCGATAC_TTGG_2	NP+DE
TCTGGAG_TTGG_2	DE+ExVE
TACGTAC_TTGG_2	DE+DE
TAGCGCA_TTGG_2	NP+DE
AGAGCAT_ACAG_2	DE+DE
GGTCTTA_ACAG_2	DE+EmVE
GATAGTC_ACAG_2	NP+DE
GTAATCC_ACAG_2	DE+DE
CGTGCAT_ACAG_2	DE+DE
GCTCATA_ACAG_2	DE+DE
ACGCTTC_ACAG_2	DE+DE
GTCGAGA_ACAG_2	NP+DE
TCTTAGG_ACAG_2	DE+ExVE
GCATGAT_ACAG_2	NP+DE
CACGAGT_ACAG_2	DE+DE
CAACGGT_ACAG_2	DE+ExVE
AGCTGTT_ACAG_2	DE+DE
GCATCGT_ACAG_2	DE+DE
CTGTATG_ACAG_2	DE+EmVE
CATGGAT_ACAG_2	NP+DE
GGTCCAT_ACAG_2	NP+DE
ATCTACG_ACAG_2	DE+EmVE
GCATGGA_ACAG_2	DE+ExVE
GGTGATC_ACAG_2	DE+DE
ATGGCTC_ACAG_2	NP+DE
CTTAAGC_ACAG_2	NP+DE
CAATGCG_ACAG_2	NP+DE
GTATGCG_ACAG_2	DE+DE
TGTCACG_ACAG_2	DE+DE
AGTCTCC_ACAG_2	DE+ExVE
ACTCAGG_ACAG_2	NP+DE
TTCCTGA_ACAG_2	DE+ExVE
GATCACA_ACAG_2	DE+DE
CAATCGA_ACAG_2	DE+DE
CTAGTGC_ACAG_2	NP+DE
TTGCCAG_ACAG_2	DE+DE
TGCACAA_ACAG_2	DE+DE
AGTGCGT_ACAG_2	NP+DE
AGCTAGT_ACAG_2	DE+DE
CTTACGG_ACAG_2	NP+DE
GCTTAGA_ACAG_2	DE+DE
ACGCTAT_ACAG_2	DE+DE
CCTGACT_ACAG_2	DE+DE
GTAGTCT_ACAG_2	DE+DE
TCGATAC_ACAG_2	DE+DE
TCTGGAG_ACAG_2	NP+DE
GGTCTTA_TGAT_6	DE+DE
GGTTCAA_TGAT_6	DE+ExVE
TATGTCC_TGAT_6	DE+EmVE
CAGGAAT_TGAT_6	DE+ExVE
GTCATGC_TGAT_6	DE+DE
CGGTCTA_TGAT_6	DE+DE
ATAGCCT_TGAT_6	DE+DE
GACCTGT_TGAT_6	DE+ExVE
TGCTGAG_TGAT_6	DE+ExVE
CGTGCAT_TGAT_6	DE+ExVE
TACCGAT_TGAT_6	DE+ExVE
TGAGCAG_TGAT_6	DE+ExVE
GTAACGT_TGAT_6	DE+DE
GCATCCA_TGAT_6	DE+ExVE
GTTCAAC_TGAT_6	DE+DE
TGGACAC_TGAT_6	DE+DE
TCTTAGG_TGAT_6	DE+DE
TCTAACG_TGAT_6	NP+DE
CACGAGT_TGAT_6	DE+DE
CAACGGT_TGAT_6	DE+DE
ACAATCG_TGAT_6	DE+ExVE
TGATGAC_TGAT_6	DE+DE
AGTACCT_TGAT_6	DE+DE
GACGCTA_TGAT_6	NP+DE
AGCAGGT_TGAT_6	DE+DE
CATGTGC_TGAT_6	NP+DE
GCATACT_TGAT_6	DE+ExVE
GTAAGTC_TGAT_6	NP+DE
CATTGTC_TGAT_6	DE+DE
GAGATCG_TGAT_6	DE+DE
CATGGAT_TGAT_6	DE+EmVE
CATTGGA_TGAT_6	DE+DE
TAGACCA_TGAT_6	DE+DE
GGTCCAT_TGAT_6	DE+EmVE
ATAGGTC_TGAT_6	DE+DE
CCTAAGG_TGAT_6	DE+DE
TGGAGCA_TGAT_6	DE+DE
CCTGATG_TGAT_6	NP+DE
GGCGATT_TGAT_6	DE+DE
GATCACA_TGAT_6	DE+DE
TACTAGC_TGAT_6	DE+ExVE
CAATCGA_TGAT_6	DE+DE
GACACTG_TGAT_6	DE+EmVE
CTAGTGC_TGAT_6	DE+DE
GCAACTA_TGAT_6	DE+DE
TTGCAGA_TGAT_6	DE+DE
ATCAGGC_TGAT_6	DE+EmVE
TACCAGT_TGAT_6	DE+ExVE
GAATAGC_TGAT_6	DE+EmVE
CAGTCAA_TGAT_6	DE+DE
CGTCAGA_TGAT_6	DE+EmVE
TCGAAGG_TGAT_6	DE+DE
TCTCGAA_TGAT_6	DE+DE
CCTGACT_TGAT_6	DE+DE
GGTTCAA_TCTA_6	DE+DE
CTGGAAG_TCTA_6	DE+DE
GTAATCC_TCTA_6	DE+DE
TCAGCCT_TCTA_6	DE+EmVE
TGCTGAG_TCTA_6	DE+DE
TACCGAT_TCTA_6	DE+DE
ACGCTTC_TCTA_6	DE+DE
AATGCCG_TCTA_6	NP+DE
GTTCAAC_TCTA_6	DE+DE
CACGAGT_TCTA_6	NP+DE
GACTGTG_TCTA_6	DE+EmVE
AGCTGTT_TCTA_6	DE+DE
ACGATGC_TCTA_6	DE+DE
GTTACCT_TCTA_6	DE+ExVE
CGATATC_TCTA_6	DE+DE
GACGCTA_TCTA_6	DE+DE
GCATCGT_TCTA_6	DE+DE
GTAAGTC_TCTA_6	DE+DE
TCGTGAG_TCTA_6	DE+ExVE
TAGACCA_TCTA_6	DE+DE
GGTCCAT_TCTA_6	DE+DE
ATAGGTC_TCTA_6	DE+DE
TGTCACG_TCTA_6	DE+DE
AGTCTCC_TCTA_6	DE+DE
TTCCTGA_TCTA_6	NP+DE
GGCGATT_TCTA_6	DE+DE
CTGTGAG_TCTA_6	DE+DE
TACTAGC_TCTA_6	DE+DE
CAATCGA_TCTA_6	DE+DE
GACACTG_TCTA_6	DE+DE
ACACGTG_TCTA_6	DE+ExVE
GGATCTA_TCTA_6	NP+DE
CTAGTGC_TCTA_6	NP+DE
GTGCTAT_TCTA_6	DE+DE
GCAACTA_TCTA_6	NP+DE
CGAGTCT_TCTA_6	DE+DE
CAGTACG_TCTA_6	DE+DE
AGGCGTT_TCTA_6	DE+DE
CGTTGAA_TCTA_6	DE+DE
CAGTCAA_TCTA_6	DE+EmVE
ACTGCAG_TCTA_6	DE+ExVE
CTACGTA_TCTA_6	NP+DE
CGCTACA_TCTA_6	NP+DE
TCGACTC_TCTA_6	NP+DE
ACGCTAT_TCTA_6	DE+DE
GGTCTTA_CTAC_5	DE+DE
GGTTCAA_CTAC_5	DE+DE
TACGACT_CTAC_5	DE+EmVE
GTCATGC_CTAC_5	NP+DE
CGGTCTA_CTAC_5	NP+DE
GACCTGT_CTAC_5	DE+DE
TGCTGAG_CTAC_5	NP+DE
CTATTCG_CTAC_5	NP+DE
CCTAAGG_CTAC_5	NP+DE
CCTGATG_CTAC_5	DE+ExVE
GGCTAGA_CTAC_5	DE+DE
GGCACTT_CTAC_5	DE+EmVE
CACAGAT_CTAC_5	DE+EmVE
GGTCTTA_ATCA_5	DE+DE
GGTTCAA_ATCA_5	DE+DE
CTGGAAG_ATCA_5	NP+DE
TATGTCC_ATCA_5	DE+ExVE
TCAGCCT_ATCA_5	NP+DE
TTCAAGC_ATCA_5	NP+DE
TGGAGCA_ATCA_5	DE+DE
GACACTG_ATCA_5	DE+DE
GGCACTT_ATCA_5	DE+EmVE
ATCTACG_TGAT_6	DE+DE
GTTAGGC_TGAT_6	DE+DE
CCATTGC_TGAT_6	DE+DE
CTCATGA_TGAT_6	DE+EmVE
GCTGACA_TGAT_6	NP+DE
GTACGGT_TGAT_6	DE+ExVE
AGATCAC_TGAT_6	NP+DE
TTGGTCA_TGAT_6	DE+DE
CGAAGGT_TGAT_6	DE+ExVE
ACAGGTA_TGAT_6	NP+DE
CAATGCG_TGAT_6	NP+DE
CAACATG_TGAT_6	DE+DE
AGCTAGT_TGAT_6	DE+DE
ATAGCGA_TGAT_6	DE+DE
AAGGTAC_TGAT_6	DE+DE
TATAGGC_TGAT_6	DE+DE
GCTTAGA_TGAT_6	DE+ExVE
CGCATAT_TGAT_6	NP+DE
AAGCCTT_TGAT_6	DE+EmVE
TCGATAC_TGAT_6	DE+ExVE
AGCCGAT_TGAT_6	DE+DE
AACTCGT_TGAT_6	NP+DE
TACCGGA_TGAT_6	DE+DE
ATTCCGT_TCTA_6	DE+DE
TAGGCAT_TCTA_6	DE+DE
CATACAG_TCTA_6	DE+DE
CGAAGGT_TCTA_6	DE+ExVE
ACAGGTA_TCTA_6	DE+ExVE
CAATGCG_TCTA_6	DE+ExVE
TATAGGC_TCTA_6	DE+DE
AGCTCAA_TCTA_6	DE+DE
CGCATAT_TCTA_6	NP+DE
CTAAGCG_TCTA_6	DE+EmVE
AAGCCTT_TCTA_6	DE+DE
AACAGCT_TCTA_6	DE+EmVE
TCTGGAG_TCTA_6	DE+DE
ATAACCG_TCTA_6	DE+DE
GCCTACA_TCTA_6	DE+DE
CTACAGC_TCTA_6	DE+DE
AACGGTG_TCTA_6	DE+ExVE
GGTTCAA_AGTC_7	NP+DE
CTGGAAG_AGTC_7	DE+DE
GTCATGC_AGTC_7	DE+DE
CGGTCTA_AGTC_7	DE+DE
CAAGGTT_AGTC_7	DE+ExVE
GACCTGT_AGTC_7	DE+ExVE
TGCTGAG_AGTC_7	DE+ExVE
CGTGCAT_AGTC_7	DE+ExVE
CACAGTA_AGTC_7	DE+EmVE
GCATCCA_AGTC_7	NP+DE
TTCAGTC_AGTC_7	DE+EmVE
TGGACAC_AGTC_7	DE+ExVE
CACGAGT_AGTC_7	DE+DE
CAACGGT_AGTC_7	DE+ExVE
GACTGTG_AGTC_7	DE+DE
CGCTTGA_AGTC_7	DE+ExVE
CTTAGTG_AGTC_7	DE+DE
ATCTGCA_AGTC_7	DE+DE
GGCGATT_AGTC_7	DE+DE
GACACTG_AGTC_7	NP+DE
CACAGAT_AGTC_7	DE+DE
GCTGAAT_AGTC_7	DE+DE
GCAACTA_AGTC_7	NP+DE
TTGCAGA_AGTC_7	DE+DE
GGTTCAA_CATG_7	DE+DE
GCATCAG_CATG_7	DE+DE
GTAATCC_CATG_7	DE+DE
TCAGCCT_CATG_7	DE+DE
CAGGAAT_CATG_7	NP+DE
GTCATGC_CATG_7	DE+DE
CGTGCAT_CATG_7	DE+DE
TACCGAT_CATG_7	DE+ExVE
TGAGCAG_CATG_7	DE+EmVE
GTAACGT_CATG_7	DE+ExVE
CATGAGG_CATG_7	DE+ExVE
ACGTTGG_CATG_7	DE+EmVE
AATGCCG_CATG_7	DE+DE
TTCAGTC_CATG_7	NP+DE
TGGACAC_CATG_7	NP+DE
GACTGTG_CATG_7	DE+DE
CTATTCG_CATG_7	DE+DE
CCTAAGG_CATG_7	DE+DE
CGCTTGA_CATG_7	NP+DE
CTTAGTG_CATG_7	NP+DE
CTGTGAG_CATG_7	NP+DE
GACACTG_CATG_7	NP+DE
ACACGTG_CATG_7	DE+ExVE
GGATCTA_CATG_7	DE+DE
CGAGTCT_CATG_7	DE+DE
TCTTCGA_TCTA_23	DE+EmVE
AACGTTC_TCTA_23	NP+DE
TCAGCCT_CTAC_36	NP+DE
CAGGAAT_CTAC_36	DE+EmVE
ACTGTCC_CTAC_36	NP+DE
CATGAGG_CTAC_36	DE+DE
ATGACGT_CTAC_36	NP+DE
CGAAGGT_CTAC_36	NP+DE
CATGAAC_CTAC_36	DE+EmVE
GGTCTTA_CTAC_9	DE+EmVE
GATAGTC_CTAC_9	NP+DE
TACGACT_CTAC_9	DE+DE
TATGTCC_CTAC_9	DE+ExVE
GGACTTC_CTAC_9	DE+DE
GTCATGC_CTAC_9	DE+ExVE
CAAGGTT_CTAC_9	DE+DE
GACCTGT_CTAC_9	DE+ExVE
TGCTGAG_CTAC_9	DE+DE
CGTGCAT_CTAC_9	DE+DE
TACCGAT_CTAC_9	NP+DE
GTCACAC_CTAC_9	DE+EmVE
CACAGTA_CTAC_9	DE+DE
GCCATTC_CTAC_9	DE+DE
ACGCTTC_CTAC_9	DE+DE
GTAACGT_CTAC_9	DE+DE
AATGCCG_CTAC_9	DE+DE
TTCAGTC_CTAC_9	NP+DE
GTCGAGA_CTAC_9	DE+EmVE
GTTCAAC_CTAC_9	DE+DE
TGGACAC_CTAC_9	DE+EmVE
GCATGAT_CTAC_9	DE+ExVE
TCTAACG_CTAC_9	DE+ExVE
CACGAGT_CTAC_9	DE+DE
CAACGGT_CTAC_9	DE+ExVE
AGCTGTT_CTAC_9	DE+DE
CGTACTC_CTAC_9	DE+DE
CTATTCG_CTAC_9	DE+DE
TTCAAGC_CTAC_9	NP+DE
CGCTTGA_CTAC_9	DE+ExVE
CATGAAC_CTAC_9	NP+DE
TGGAGCA_CTAC_9	NP+DE
AGTCTCC_CTAC_9	DE+ExVE
GCTTCAT_CTAC_9	DE+DE
ACTCAGG_CTAC_9	DE+DE
ATCTGCA_CTAC_9	DE+EmVE
TTCCTGA_CTAC_9	DE+DE
GGCGATT_CTAC_9	DE+DE
CTGTGAG_CTAC_9	DE+ExVE
GATCACA_CTAC_9	DE+DE
TACTAGC_CTAC_9	NP+DE
GGCTAGA_CTAC_9	NP+DE
CAATCGA_CTAC_9	DE+DE
GACACTG_CTAC_9	DE+ExVE
GGCACTT_CTAC_9	DE+DE
CACAGAT_CTAC_9	DE+ExVE
ACACGTG_CTAC_9	NP+DE
GCAGTAG_CTAC_9	NP+DE
GGATCTA_CTAC_9	DE+DE
GCTGAAT_CTAC_9	NP+DE
CTAGTGC_CTAC_9	DE+ExVE
GTGCTAT_CTAC_9	DE+DE
GCAACTA_CTAC_9	DE+ExVE
TTGCCAG_CTAC_9	DE+ExVE
TTGCAGA_CTAC_9	DE+DE
ATCAGGC_CTAC_9	NP+DE
CGAGTCT_CTAC_9	DE+DE
GGTCTTA_ATCA_9	DE+ExVE
GGTTCAA_ATCA_9	DE+DE
GATAGTC_ATCA_9	DE+ExVE
GCATCAG_ATCA_9	DE+DE
TATGTCC_ATCA_9	NP+DE
GTAATCC_ATCA_9	NP+DE
TCAGCCT_ATCA_9	NP+DE
CAGGAAT_ATCA_9	NP+DE
CGGTCTA_ATCA_9	DE+ExVE
CAAGGTT_ATCA_9	DE+ExVE
TGCTGAG_ATCA_9	DE+DE
CGTGCAT_ATCA_9	DE+DE
TACCGAT_ATCA_9	DE+DE
CACAGTA_ATCA_9	NP+DE
GCTCATA_ATCA_9	DE+DE
GCCATTC_ATCA_9	DE+DE
TGAGCAG_ATCA_9	DE+DE
ACTGTCC_ATCA_9	NP+DE
CATGAGG_ATCA_9	DE+DE
ACGTTGG_ATCA_9	DE+DE
AATGCCG_ATCA_9	DE+DE
TTCAGTC_ATCA_9	DE+EmVE
GTCGAGA_ATCA_9	DE+DE
GTTCAAC_ATCA_9	DE+DE
TCTTAGG_ATCA_9	DE+DE
TCTAACG_ATCA_9	DE+ExVE
CACGAGT_ATCA_9	DE+DE
CAACGGT_ATCA_9	DE+ExVE
AGCTGTT_ATCA_9	DE+EmVE
CTATTCG_ATCA_9	DE+DE
GTATGCG_ATCA_9	DE+DE
TGTCACG_ATCA_9	DE+ExVE
CCTAAGG_ATCA_9	NP+DE
TTCAAGC_ATCA_9	DE+DE
CATGAAC_ATCA_9	DE+ExVE
CTTAGTG_ATCA_9	DE+DE
TGGAGCA_ATCA_9	DE+DE
CCTGATG_ATCA_9	DE+DE
ACTCAGG_ATCA_9	DE+ExVE
ATCTGCA_ATCA_9	NP+DE
TTCCTGA_ATCA_9	DE+ExVE
GGCGATT_ATCA_9	DE+DE
CTGTGAG_ATCA_9	DE+DE
TACTAGC_ATCA_9	DE+DE
GGCTAGA_ATCA_9	NP+DE
GACACTG_ATCA_9	DE+DE
CACAGAT_ATCA_9	NP+DE
ACACGTG_ATCA_9	DE+DE
GGATCTA_ATCA_9	DE+DE
GCTGAAT_ATCA_9	DE+ExVE
CTAGTGC_ATCA_9	NP+DE
GTGCTAT_ATCA_9	DE+DE
GCAACTA_ATCA_9	DE+ExVE
TTGCCAG_ATCA_9	DE+DE
TTGCAGA_ATCA_9	DE+DE
ATCAGGC_ATCA_9	DE+EmVE
CGAGTCT_ATCA_9	DE+DE
ACTCAGG_TTGG_29	NP+DE
CGCATAT_TTGG_29	DE+ExVE
TCAGCCT_ACAG_29	DE+EmVE
TGTCACG_ACAG_29	DE+DE
CGAAGGT_TCTA_32	DE+DE
GTTGACT_TCTA_32	DE+DE