Cell	cell_type
CGATATC_AGTC_7	EmVE+EmVE
AACATCG_AGTC_7	ExVE+EmVE
AGCACTG_AGTC_7	EmVE+EmVE
CTACGTA_AGTC_7	EmVE+EmVE
AGTGCGT_AGTC_7	ExVE+EmVE
CATGCTG_AGTC_7	EmVE+EmVE
GTAGTCT_AGTC_7	ExVE+EmVE
TCACAAG_AGTC_7	EmVE+EmVE
GAGCTAG_CATG_7	ExVE+EmVE
CTGTATG_CATG_7	ExVE+EmVE
GGTCCAT_CATG_7	EmVE+EmVE
ATTCCGT_CATG_7	EmVE+EmVE
CAGTACG_CATG_7	EmVE+EmVE
ATGCCAA_CATG_7	ExVE+EmVE
AGTGCGT_CATG_7	ExVE+EmVE
CCTGACT_CATG_7	ExVE+EmVE
GTCATGC_TTGG_8	ExVE+EmVE
AATGCCG_TTGG_8	ExVE+EmVE
GCATGAT_TTGG_8	EmVE+EmVE
TCTAACG_TTGG_8	EmVE+EmVE
GTTAGGC_TTGG_8	EmVE+EmVE
CCATTGC_TTGG_8	EmVE+EmVE
ATTCCGT_TTGG_8	ExVE+EmVE
TCTTCGA_TTGG_8	EmVE+EmVE
CTTGCAG_TTGG_8	ExVE+EmVE
AAGCCTT_TTGG_8	EmVE+EmVE
TACGAGG_TTGG_8	EmVE+EmVE
CTGGAAG_ACAG_8	EmVE+EmVE
TTCAGTC_ACAG_8	ExVE+EmVE
GTCGAGA_ACAG_8	ExVE+EmVE
GTTCAAC_ACAG_8	EmVE+EmVE
CACGAGT_ACAG_8	ExVE+EmVE
AGCTGTT_ACAG_8	ExVE+EmVE
AGATGCG_ACAG_8	EmVE+EmVE
TGAGACC_ACAG_8	ExVE+EmVE
TCGTGAG_ACAG_8	EmVE+EmVE
CATGGAT_ACAG_8	DE+EmVE
CCTGATG_ACAG_8	EmVE+EmVE
GGCACTT_ACAG_8	ExVE+EmVE
CACAGAT_ACAG_8	ExVE+EmVE
ACACGTG_ACAG_8	EmVE+EmVE
GCAGTAG_ACAG_8	ExVE+EmVE
CTAGTGC_ACAG_8	EmVE+EmVE
GCAACTA_ACAG_8	EmVE+EmVE
ACCGATC_ACAG_8	EmVE+EmVE
ACTGCAG_ACAG_8	ExVE+EmVE
TCGACTC_ACAG_8	ExVE+EmVE
ATAGCGA_ACAG_8	ExVE+EmVE
GCTTAGA_ACAG_8	EmVE+EmVE
AAGCCTT_ACAG_8	ExVE+EmVE
ATAGCCT_AGTC_33	EmVE+EmVE
GCATGAT_AGTC_33	EmVE+EmVE
GACTGTG_AGTC_33	ExVE+EmVE
CGTACTC_AGTC_33	EmVE+EmVE
TGATGAC_AGTC_33	DE+EmVE
GCATCGT_AGTC_33	EmVE+EmVE
GGTCCAT_AGTC_33	EmVE+EmVE
ATCTACG_AGTC_33	EmVE+EmVE
GTTAGGC_AGTC_33	EmVE+EmVE
CAACATG_AGTC_33	ExVE+EmVE
GGTCTTA_CATG_33	EmVE+EmVE
GGACTTC_CATG_33	ExVE+EmVE
ATAGCCT_CATG_33	EmVE+EmVE
CGTGCAT_CATG_33	EmVE+EmVE
TACCGAT_CATG_33	EmVE+EmVE
GTCACAC_CATG_33	EmVE+EmVE
CGTACTC_CATG_33	ExVE+EmVE
CGATATC_CATG_33	EmVE+EmVE
ATCTACG_CATG_33	EmVE+EmVE
GCATGGA_CATG_33	ExVE+EmVE
CAACATG_CATG_33	EmVE+EmVE
CGTGCAT_AGTC_3	ExVE+EmVE
GTCACAC_AGTC_3	EmVE+EmVE
CACAGTA_AGTC_3	EmVE+EmVE
GCTCATA_AGTC_3	EmVE+EmVE
GCATCCA_AGTC_3	ExVE+EmVE
GTCGAGA_AGTC_3	EmVE+EmVE
CTATTCG_AGTC_3	EmVE+EmVE
GATCACA_AGTC_3	EmVE+EmVE
GGTTCAA_CATG_3	ExVE+EmVE
CGTGCAT_CATG_3	EmVE+EmVE
ACGCTTC_CATG_3	ExVE+EmVE
GTAACGT_CATG_3	ExVE+EmVE
AATGCCG_CATG_3	EmVE+EmVE
TTCAGTC_CATG_3	ExVE+EmVE
CCTAAGG_CATG_3	ExVE+EmVE
CATGAAC_CATG_3	ExVE+EmVE
GATCACA_CATG_3	ExVE+EmVE
TCTTAGG_AGTC_3	EmVE+EmVE
AGATGCG_AGTC_3	EmVE+EmVE
CTTGTAC_AGTC_3	EmVE+EmVE
TTGCCAG_AGTC_3	EmVE+EmVE
AGGCTAG_AGTC_3	ExVE+EmVE
AGCACTG_AGTC_3	EmVE+EmVE
TGCCTAA_AGTC_3	ExVE+EmVE
AGCTAGT_AGTC_3	EmVE+EmVE
CATGTGC_CATG_3	ExVE+EmVE
ATTCCGT_CATG_3	EmVE+EmVE
GCTGAAT_CATG_3	ExVE+EmVE
TCTTCGA_CATG_3	ExVE+EmVE
ATGCCAA_CATG_3	EmVE+EmVE
CATGCTG_CATG_3	EmVE+EmVE
ACTTGGC_CATG_3	EmVE+EmVE
CTAAGCG_CATG_3	EmVE+EmVE
GGTTCAA_TTGG_2	EmVE+EmVE
GATAGTC_TTGG_2	ExVE+EmVE
CAGGAAT_TTGG_2	EmVE+EmVE
CGGTCTA_TTGG_2	ExVE+EmVE
ACGTTGG_TTGG_2	ExVE+EmVE
GCATCCA_TTGG_2	ExVE+EmVE
CAACGGT_TTGG_2	ExVE+EmVE
ACAATCG_TTGG_2	ExVE+EmVE
AGATGCG_TTGG_2	EmVE+EmVE
GCATCGT_TTGG_2	ExVE+EmVE
AGCAGGT_TTGG_2	ExVE+EmVE
TGAGACC_TTGG_2	EmVE+EmVE
CATTGTC_TTGG_2	EmVE+EmVE
TCGTGAG_TTGG_2	ExVE+EmVE
ATCTACG_TTGG_2	ExVE+EmVE
GCTGACA_TTGG_2	EmVE+EmVE
ATTCCGT_TTGG_2	EmVE+EmVE
GCATGGA_TTGG_2	EmVE+EmVE
GGAACCT_TTGG_2	EmVE+EmVE
TAGGCAT_TTGG_2	ExVE+EmVE
GTACGGT_TTGG_2	EmVE+EmVE
CTTAAGC_TTGG_2	DE+EmVE
TTGGTCA_TTGG_2	EmVE+EmVE
CAATGCG_TTGG_2	EmVE+EmVE
CCTAAGG_TTGG_2	DE+EmVE
AGTCTCC_TTGG_2	ExVE+EmVE
GATCACA_TTGG_2	EmVE+EmVE
GGCACTT_TTGG_2	ExVE+EmVE
CTAGTGC_TTGG_2	ExVE+EmVE
GTGCTAT_TTGG_2	EmVE+EmVE
TTGCAGA_TTGG_2	EmVE+EmVE
TCTTCGA_TTGG_2	ExVE+EmVE
CGTTGAA_TTGG_2	EmVE+EmVE
CGGATTA_TTGG_2	EmVE+EmVE
CGTCAGA_TTGG_2	EmVE+EmVE
AGCACTG_TTGG_2	EmVE+EmVE
GGAGACT_TTGG_2	ExVE+EmVE
ATGCCAA_TTGG_2	EmVE+EmVE
TGCCTAA_TTGG_2	EmVE+EmVE
AGCTAGT_TTGG_2	EmVE+EmVE
ATAGCGA_TTGG_2	EmVE+EmVE
CCATGGT_TTGG_2	EmVE+EmVE
CGCATAT_TTGG_2	ExVE+EmVE
AACAGCT_TTGG_2	ExVE+EmVE
GCCTACA_TTGG_2	ExVE+EmVE
CTACAAG_TTGG_2	ExVE+EmVE
CTACAGC_TTGG_2	ExVE+EmVE
TGACGGA_TTGG_2	EmVE+EmVE
TACCGGA_TTGG_2	ExVE+EmVE
GGTTCAA_ACAG_2	ExVE+EmVE
CTGGAAG_ACAG_2	EmVE+EmVE
GTCATGC_ACAG_2	EmVE+EmVE
CAAGGTT_ACAG_2	ExVE+EmVE
GTCACAC_ACAG_2	ExVE+EmVE
GCCATTC_ACAG_2	EmVE+EmVE
TTCAGTC_ACAG_2	EmVE+EmVE
TGATGAC_ACAG_2	EmVE+EmVE
AGTACCT_ACAG_2	DE+EmVE
AGCAGGT_ACAG_2	ExVE+EmVE
CATTGTC_ACAG_2	EmVE+EmVE
CATTGGA_ACAG_2	EmVE+EmVE
GTTAGGC_ACAG_2	ExVE+EmVE
GCTGACA_ACAG_2	ExVE+EmVE
GGAACCT_ACAG_2	EmVE+EmVE
CATACAG_ACAG_2	EmVE+EmVE
CAACATG_ACAG_2	DE+EmVE
TGGAGCA_ACAG_2	ExVE+EmVE
CTGTGAG_ACAG_2	ExVE+EmVE
TACTAGC_ACAG_2	EmVE+EmVE
GACACTG_ACAG_2	EmVE+EmVE
CACAGAT_ACAG_2	ExVE+EmVE
GGATCTA_ACAG_2	ExVE+EmVE
GCTGAAT_ACAG_2	DE+EmVE
TTGCAGA_ACAG_2	ExVE+EmVE
CTTGCAG_ACAG_2	EmVE+EmVE
CGTCAGA_ACAG_2	EmVE+EmVE
GGAGACT_ACAG_2	EmVE+EmVE
CGCTACA_ACAG_2	ExVE+EmVE
TCGAAGG_ACAG_2	ExVE+EmVE
CGTAACT_ACAG_2	ExVE+EmVE
ATAGCGA_ACAG_2	ExVE+EmVE
AGCTCAA_ACAG_2	ExVE+EmVE
CGCATAT_ACAG_2	EmVE+EmVE
CTAAGCG_ACAG_2	EmVE+EmVE
TAGCGCA_ACAG_2	EmVE+EmVE
GCCTACA_ACAG_2	ExVE+EmVE
AGCCGAT_ACAG_2	ExVE+EmVE
GTCACAC_TGAT_6	ExVE+EmVE
ACGTTGG_TGAT_6	EmVE+EmVE
GACTGTG_TGAT_6	ExVE+EmVE
ACGATGC_TGAT_6	ExVE+EmVE
GAGCTAG_TGAT_6	EmVE+EmVE
AGTCGAC_TGAT_6	EmVE+EmVE
CGATATC_TGAT_6	ExVE+EmVE
GCATCGT_TGAT_6	ExVE+EmVE
TGAGACC_TGAT_6	EmVE+EmVE
CTTAGTG_TGAT_6	EmVE+EmVE
ATCTGCA_TGAT_6	ExVE+EmVE
GGCTAGA_TGAT_6	ExVE+EmVE
GCTGAAT_TGAT_6	EmVE+EmVE
GTGCTAT_TGAT_6	EmVE+EmVE
CGAGTCT_TGAT_6	ExVE+EmVE
CTGATGG_TGAT_6	DE+EmVE
AGAGCAT_TCTA_6	ExVE+EmVE
CAGGAAT_TCTA_6	EmVE+EmVE
CATGAGG_TCTA_6	ExVE+EmVE
ACGTTGG_TCTA_6	ExVE+EmVE
GCATGAT_TCTA_6	EmVE+EmVE
GAGCTAG_TCTA_6	EmVE+EmVE
GCATACT_TCTA_6	ExVE+EmVE
CTTGTAC_TCTA_6	EmVE+EmVE
AACATCG_TCTA_6	ExVE+EmVE
GTATGCG_TCTA_6	EmVE+EmVE
GATCACA_TCTA_6	ExVE+EmVE
GCTGAAT_TCTA_6	EmVE+EmVE
TTGCCAG_TCTA_6	ExVE+EmVE
ACCGATC_TCTA_6	ExVE+EmVE
ATGCCAA_TCTA_6	EmVE+EmVE
CAAGGTT_CTAC_5	ExVE+EmVE
TACCGAT_CTAC_5	EmVE+EmVE
CACAGTA_CTAC_5	ExVE+EmVE
GCTCATA_CTAC_5	EmVE+EmVE
CTTAGTG_CTAC_5	EmVE+EmVE
AGAGCAT_ATCA_5	ExVE+EmVE
GTAATCC_ATCA_5	ExVE+EmVE
GTCATGC_ATCA_5	EmVE+EmVE
CGTGCAT_ATCA_5	EmVE+EmVE
GTCACAC_ATCA_5	EmVE+EmVE
GCCATTC_ATCA_5	EmVE+EmVE
CTATTCG_ATCA_5	ExVE+EmVE
CCTAAGG_ATCA_5	ExVE+EmVE
CATGAAC_ATCA_5	EmVE+EmVE
CTTAAGC_TGAT_6	EmVE+EmVE
TGCTACT_TGAT_6	ExVE+EmVE
CAGCGTA_TGAT_6	EmVE+EmVE
CGTAACT_TGAT_6	EmVE+EmVE
ACTTGGC_TGAT_6	EmVE+EmVE
GTAGTCT_TGAT_6	EmVE+EmVE
ATAACCG_TGAT_6	EmVE+EmVE
AACGGTG_TGAT_6	EmVE+EmVE
ATCTACG_TCTA_6	ExVE+EmVE
GGAACCT_TCTA_6	EmVE+EmVE
ATGGCTC_TCTA_6	EmVE+EmVE
GTACGGT_TCTA_6	ExVE+EmVE
TTGGTCA_TCTA_6	ExVE+EmVE
CAGCGTA_TCTA_6	ExVE+EmVE
CGTAACT_TCTA_6	ExVE+EmVE
CTTACGG_TCTA_6	EmVE+EmVE
ATAGCGA_TCTA_6	EmVE+EmVE
TACGAGG_TCTA_6	EmVE+EmVE
TCGATAC_TCTA_6	EmVE+EmVE
TAGCGCA_TCTA_6	EmVE+EmVE
AGCCGAT_TCTA_6	EmVE+EmVE
TACGACT_AGTC_7	EmVE+EmVE
TACCGAT_AGTC_7	ExVE+EmVE
ACTGTCC_AGTC_7	ExVE+EmVE
CATGAGG_AGTC_7	EmVE+EmVE
AGTCTCC_AGTC_7	ExVE+EmVE
TACTAGC_AGTC_7	EmVE+EmVE
CTTCGAA_AGTC_7	EmVE+EmVE
CACAGTA_CATG_7	ExVE+EmVE
GTTCAAC_CATG_7	EmVE+EmVE
TCTTAGG_CATG_7	DE+EmVE
CACGAGT_CATG_7	EmVE+EmVE
TTCAAGC_CATG_7	ExVE+EmVE
AGTCTCC_CATG_7	ExVE+EmVE
GTGCTAT_CATG_7	ExVE+EmVE
TTGCAGA_CATG_7	EmVE+EmVE
ATCAGGC_CATG_7	EmVE+EmVE
TGAGCAG_CTAC_13	EmVE+EmVE
CATGGAT_CTAC_13	EmVE+EmVE
ACGGATA_CTAC_13	EmVE+EmVE
CATGAAC_CTAC_13	EmVE+EmVE
GTCATGC_TCTA_16	EmVE+EmVE
GTAAGTC_TCTA_16	EmVE+EmVE
ATGGCTC_TCTA_16	ExVE+EmVE
ACAGGTA_TCTA_16	ExVE+EmVE
AGCTCAA_TCTA_16	EmVE+EmVE
ATCTACG_TCTA_23	ExVE+EmVE
AGCTAGT_TCTA_23	EmVE+EmVE
GGAACCT_CTAC_36	ExVE+EmVE
CAATGCG_ATCA_14	EmVE+EmVE
TTCAAGC_ATCA_14	EmVE+EmVE
TTGCCAG_ATCA_14	ExVE+EmVE
CAGTACG_ATCA_14	EmVE+EmVE
TCGTGAG_ATCA_9	ExVE+EmVE
GAGCTAG_TGAT_15	ExVE+EmVE
TGTCACG_TGAT_15	EmVE+EmVE
GGATCTA_TGAT_15	ExVE+EmVE
TACGAGG_TGAT_15	EmVE+EmVE
ACTGTCC_CTAC_9	EmVE+EmVE
GTATGCG_CTAC_9	ExVE+EmVE
CGCTTGA_ATCA_9	EmVE+EmVE
GATCACA_ATCA_9	ExVE+EmVE
CAGTCAA_TTGG_19	ExVE+EmVE
AACATCG_ACAG_19	ExVE+EmVE
CCTGACT_ACAG_19	ExVE+EmVE
TGACGGA_TTGG_19	ExVE+EmVE
GGCGATT_TGAT_22	ExVE+EmVE
CGTACTC_CTAC_20	ExVE+EmVE
TTCAAGC_CTAC_20	DE+EmVE
CACAGAT_CTAC_20	ExVE+EmVE
CTTACGG_CTAC_20	EmVE+EmVE
ATGCCAA_TGAT_43	ExVE+EmVE
GGCGATT_ACAG_29	ExVE+EmVE
GGTGATC_TGAT_32	EmVE+EmVE
ATTCCGT_TCTA_32	EmVE+EmVE
ATCTGTC_TCTA_32	ExVE+EmVE
TAGCGCA_TCTA_32	EmVE+EmVE
CTACAGC_TCTA_32	ExVE+EmVE