Cell	cell_type
GAGATCG_AGTC_7	DE+ExVE
ATCTACG_AGTC_7	ExVE+EmVE
GCTGACA_AGTC_7	ExVE+EmVE
ACGGATA_AGTC_7	ExVE+EmVE
ATTCCGT_AGTC_7	FG+ExVE
GCATGGA_AGTC_7	ExVE+EmVE
CAACATG_AGTC_7	ExVE+EmVE
TCTTCGA_AGTC_7	ExVE+EmVE
GAATAGC_AGTC_7	FG+ExVE
CGTTGAA_AGTC_7	ExVE+EmVE
CAGTCAA_AGTC_7	ExVE+EmVE
CTGATGG_AGTC_7	ExVE+EmVE
AACAGCT_AGTC_7	ExVE+EmVE
TCGATAC_AGTC_7	FG+ExVE
TCTGGAG_AGTC_7	ExVE+EmVE
AGCCGAT_AGTC_7	FG+ExVE
GACGCTA_CATG_7	ExVE+EmVE
GCATCGT_CATG_7	ExVE+EmVE
AGCAGGT_CATG_7	ExVE+EmVE
CATGTGC_CATG_7	ExVE+EmVE
TCGTGAG_CATG_7	ExVE+EmVE
GGAACCT_CATG_7	ExVE+EmVE
ATGGCTC_CATG_7	ExVE+EmVE
CTTAAGC_CATG_7	ExVE+EmVE
CAACATG_CATG_7	ExVE+EmVE
CTTACGG_CATG_7	ExVE+EmVE
CATGCTG_CATG_7	ExVE+EmVE
GCTTAGA_CATG_7	ExVE+EmVE
ACGCTAT_CATG_7	ExVE+EmVE
CTACAGC_CATG_7	ExVE+EmVE
AACTCGT_CATG_7	ExVE+EmVE
GGTCTTA_TTGG_8	ExVE+EmVE
CAAGGTT_TTGG_8	ExVE+EmVE
TGCTGAG_TTGG_8	ExVE+EmVE
CGTGCAT_TTGG_8	ExVE+EmVE
GCTCATA_TTGG_8	ExVE+EmVE
ACTGTCC_TTGG_8	ExVE+EmVE
ACGTTGG_TTGG_8	ExVE+EmVE
TCTTAGG_TTGG_8	ExVE+EmVE
CACGAGT_TTGG_8	MG+ExVE
ACAATCG_TTGG_8	ExVE+EmVE
TGATGAC_TTGG_8	ExVE+EmVE
GCATCGT_TTGG_8	ExVE+EmVE
GCATACT_TTGG_8	ExVE+EmVE
AACATCG_TTGG_8	ExVE+EmVE
ATGACGT_TTGG_8	ExVE+EmVE
ACGGATA_TTGG_8	ExVE+EmVE
GGAACCT_TTGG_8	ExVE+EmVE
GGTGATC_TTGG_8	MG+ExVE
GGCTAGA_TTGG_8	ExVE+EmVE
GGATCTA_TTGG_8	ExVE+EmVE
GTGCTAT_TTGG_8	ExVE+EmVE
GCAACTA_TTGG_8	DE+ExVE
ATCAGGC_TTGG_8	ExVE+EmVE
TACCAGT_TTGG_8	ExVE+EmVE
GAATAGC_TTGG_8	ExVE+EmVE
AGGCTAG_TTGG_8	ExVE+EmVE
AGGCGTT_TTGG_8	ExVE+EmVE
GGAGACT_TTGG_8	DE+ExVE
ATGCCAA_TTGG_8	ExVE+EmVE
TCTCGAA_TTGG_8	ExVE+EmVE
TGCCTAA_TTGG_8	ExVE+EmVE
CATGCTG_TTGG_8	ExVE+EmVE
GCTTAGA_TTGG_8	ExVE+EmVE
GTAGTCT_TTGG_8	ExVE+EmVE
TACGTAC_TTGG_8	ExVE+EmVE
GATAGTC_ACAG_8	ExVE+EmVE
CAAGGTT_ACAG_8	ExVE+EmVE
CAACGGT_ACAG_8	ExVE+EmVE
CGTACTC_ACAG_8	ExVE+EmVE
GTTACCT_ACAG_8	ExVE+EmVE
GAGATCG_ACAG_8	ExVE+EmVE
GCTGACA_ACAG_8	ExVE+EmVE
ACGGATA_ACAG_8	ExVE+EmVE
GGTGATC_ACAG_8	ExVE+EmVE
ATGGCTC_ACAG_8	ExVE+EmVE
AGTCTCC_ACAG_8	ExVE+EmVE
ACTCAGG_ACAG_8	ExVE+EmVE
CTGTGAG_ACAG_8	DE+ExVE
GGATCTA_ACAG_8	ExVE+EmVE
CGAGTCT_ACAG_8	ExVE+EmVE
CAGTACG_ACAG_8	MG+ExVE
CTTGCAG_ACAG_8	ExVE+EmVE
CGTTGAA_ACAG_8	ExVE+EmVE
CGGATTA_ACAG_8	ExVE+EmVE
AGCACTG_ACAG_8	MG+ExVE
CGCTACA_ACAG_8	ExVE+EmVE
TCTCGAA_ACAG_8	ExVE+EmVE
AGCTAGT_ACAG_8	ExVE+EmVE
CATGCTG_ACAG_8	ExVE+EmVE
AAGGTAC_ACAG_8	ExVE+EmVE
TCGATAC_ACAG_8	FG+ExVE
TCTGGAG_ACAG_8	ExVE+EmVE
CATTGGA_AGTC_33	ExVE+EmVE
ATGGCTC_AGTC_33	ExVE+EmVE
TTGGTCA_AGTC_33	ExVE+EmVE
ACGCTTC_CATG_33	ExVE+EmVE
CACGAGT_CATG_33	ExVE+EmVE
CATTGGA_CATG_33	ExVE+EmVE
CAGCGTA_CATG_33	ExVE+EmVE
CAGGAAT_AGTC_3	ExVE+EmVE
TACCGAT_AGTC_3	ExVE+EmVE
ACTCAGG_AGTC_3	ExVE+EmVE
CAATCGA_AGTC_3	ExVE+EmVE
GGCACTT_AGTC_3	ExVE+EmVE
ACACGTG_AGTC_3	ExVE+EmVE
GATAGTC_CATG_3	ExVE+EmVE
GCATCAG_CATG_3	ExVE+EmVE
CAGGAAT_CATG_3	ExVE+EmVE
CGGTCTA_CATG_3	ExVE+EmVE
TACCGAT_CATG_3	ExVE+EmVE
GCCATTC_CATG_3	ExVE+EmVE
GTCGAGA_CATG_3	ExVE+EmVE
ACTCAGG_CATG_3	DE+ExVE
TCTAACG_AGTC_3	ExVE+EmVE
GACTGTG_AGTC_3	ExVE+EmVE
CGTACTC_AGTC_3	ExVE+EmVE
GAGCTAG_AGTC_3	ExVE+EmVE
AGTACCT_AGTC_3	ExVE+EmVE
GCATCGT_AGTC_3	ExVE+EmVE
AACATCG_AGTC_3	ExVE+EmVE
CATGGAT_AGTC_3	ExVE+EmVE
ATGACGT_AGTC_3	ExVE+EmVE
CTCATGA_AGTC_3	ExVE+EmVE
ATTCCGT_AGTC_3	ExVE+EmVE
CGAAGGT_AGTC_3	ExVE+EmVE
CAATGCG_AGTC_3	ExVE+EmVE
GCAGTAG_AGTC_3	DE+ExVE
CTTCGAA_AGTC_3	ExVE+EmVE
GAATAGC_AGTC_3	DE+ExVE
CGTTGAA_AGTC_3	DE+ExVE
CTACGTA_AGTC_3	ExVE+EmVE
AGTGCGT_AGTC_3	ExVE+EmVE
GCTTAGA_AGTC_3	ExVE+EmVE
CCTGACT_AGTC_3	ExVE+EmVE
AGCTCAA_AGTC_3	ExVE+EmVE
GCATGAT_CATG_3	ExVE+EmVE
AGCTGTT_CATG_3	ExVE+EmVE
ACAATCG_CATG_3	FG+ExVE
GTTACCT_CATG_3	ExVE+EmVE
GACGCTA_CATG_3	ExVE+EmVE
CTTGTAC_CATG_3	ExVE+EmVE
GTAAGTC_CATG_3	ExVE+EmVE
CATTGTC_CATG_3	ExVE+EmVE
AACATCG_CATG_3	ExVE+EmVE
CATGGAT_CATG_3	DE+ExVE
ACGGATA_CATG_3	ExVE+EmVE
TAGGCAT_CATG_3	ExVE+EmVE
ATGGCTC_CATG_3	ExVE+EmVE
CAGCGTA_CATG_3	ExVE+EmVE
CAACATG_CATG_3	ExVE+EmVE
GGATCTA_CATG_3	DE+ExVE
TTGCCAG_CATG_3	ExVE+EmVE
CGTCAGA_CATG_3	ExVE+EmVE
CGCTACA_CATG_3	ExVE+EmVE
TCGAAGG_CATG_3	ExVE+EmVE
TGCCTAA_CATG_3	ExVE+EmVE
TCGACTC_CATG_3	ExVE+EmVE
ATAGCGA_CATG_3	ExVE+EmVE
GTAGTCT_CATG_3	ExVE+EmVE
TACGAGG_CATG_3	ExVE+EmVE
TCTGGAG_CATG_3	ExVE+EmVE
GGTCTTA_TTGG_2	ExVE+EmVE
CAAGGTT_TTGG_2	ExVE+EmVE
GTCACAC_TTGG_2	ExVE+EmVE
TGAGCAG_TTGG_2	ExVE+EmVE
GTCGAGA_TTGG_2	ExVE+EmVE
TCTTAGG_TTGG_2	ExVE+EmVE
CACGAGT_TTGG_2	ExVE+EmVE
AGTCGAC_TTGG_2	ExVE+EmVE
AGTACCT_TTGG_2	ExVE+EmVE
GCATACT_TTGG_2	ExVE+EmVE
GTAAGTC_TTGG_2	MG+ExVE
CTCATGA_TTGG_2	ExVE+EmVE
ACGGATA_TTGG_2	ExVE+EmVE
CATACAG_TTGG_2	FG+ExVE
ACAGGTA_TTGG_2	ExVE+EmVE
TTCAAGC_TTGG_2	ExVE+EmVE
GCTTCAT_TTGG_2	ExVE+EmVE
ATCTGCA_TTGG_2	DE+ExVE
CTGTGAG_TTGG_2	ExVE+EmVE
GGATCTA_TTGG_2	ExVE+EmVE
AGGCTAG_TTGG_2	ExVE+EmVE
CATGCTG_TTGG_2	ExVE+EmVE
AGCTCAA_TTGG_2	ExVE+EmVE
AAGCCTT_TTGG_2	ExVE+EmVE
CGGTCTA_ACAG_2	ExVE+EmVE
ATAGCCT_ACAG_2	ExVE+EmVE
CACAGTA_ACAG_2	ExVE+EmVE
CATGAGG_ACAG_2	ExVE+EmVE
AATGCCG_ACAG_2	ExVE+EmVE
TGGACAC_ACAG_2	ExVE+EmVE
GACTGTG_ACAG_2	ExVE+EmVE
CGTACTC_ACAG_2	ExVE+EmVE
GAGCTAG_ACAG_2	DE+ExVE
ATGACGT_ACAG_2	ExVE+EmVE
ATAGGTC_ACAG_2	ExVE+EmVE
CCATTGC_ACAG_2	ExVE+EmVE
ACGGATA_ACAG_2	ExVE+EmVE
ATTCCGT_ACAG_2	ExVE+EmVE
TGCTACT_ACAG_2	ExVE+EmVE
CAGCGTA_ACAG_2	ExVE+EmVE
CTTAGTG_ACAG_2	ExVE+EmVE
CCTGATG_ACAG_2	ExVE+EmVE
ATCTGCA_ACAG_2	ExVE+EmVE
GGCTAGA_ACAG_2	ExVE+EmVE
GGCACTT_ACAG_2	ExVE+EmVE
GCAGTAG_ACAG_2	ExVE+EmVE
CTTCGAA_ACAG_2	ExVE+EmVE
GAATAGC_ACAG_2	DE+ExVE
ACCGATC_ACAG_2	ExVE+EmVE
CTGATGG_ACAG_2	DE+ExVE
TCGACTC_ACAG_2	ExVE+EmVE
ATAACCG_ACAG_2	ExVE+EmVE
CTACAGC_ACAG_2	FG+ExVE
AACGGTG_ACAG_2	ExVE+EmVE
TGACGGA_ACAG_2	ExVE+EmVE
TACGACT_TGAT_6	ExVE+EmVE
CGTACTC_TGAT_6	ExVE+EmVE
GTTACCT_TGAT_6	ExVE+EmVE
AACATCG_TGAT_6	DE+ExVE
CTGTATG_TGAT_6	ExVE+EmVE
TGTCACG_TGAT_6	ExVE+EmVE
GCTTCAT_TGAT_6	FG+ExVE
CTTGCAG_TGAT_6	ExVE+EmVE
CGTTGAA_TGAT_6	ExVE+EmVE
TGCACAA_TGAT_6	FG+ExVE
CGCTACA_TGAT_6	ExVE+EmVE
GGTCTTA_TCTA_6	ExVE+EmVE
GTCACAC_TCTA_6	ExVE+EmVE
TGAGCAG_TCTA_6	ExVE+EmVE
TGGACAC_TCTA_6	ExVE+EmVE
CAACGGT_TCTA_6	ExVE+EmVE
CGTACTC_TCTA_6	ExVE+EmVE
ACAATCG_TCTA_6	ExVE+EmVE
AGCAGGT_TCTA_6	ExVE+EmVE
CATGGAT_TCTA_6	ExVE+EmVE
CTATTCG_TCTA_6	ExVE+EmVE
GGCTAGA_TCTA_6	ExVE+EmVE
AGGCTAG_TCTA_6	ExVE+EmVE
GATAGTC_CTAC_5	ExVE+EmVE
TCAGCCT_CTAC_5	ExVE+EmVE
GGACTTC_CTAC_5	ExVE+EmVE
CAGGAAT_CTAC_5	DE+ExVE
GTCACAC_CTAC_5	DE+ExVE
TGGAGCA_CTAC_5	ExVE+EmVE
GATAGTC_ATCA_5	ExVE+EmVE
CAAGGTT_ATCA_5	ExVE+EmVE
CACAGTA_ATCA_5	ExVE+EmVE
CGCTTGA_ATCA_5	ExVE+EmVE
CTTAGTG_ATCA_5	ExVE+EmVE
GGCTAGA_ATCA_5	MG+ExVE
ACGGATA_TGAT_6	ExVE+EmVE
TAGGCAT_TGAT_6	ExVE+EmVE
GTTGACT_TGAT_6	ExVE+EmVE
ACGCTAT_TGAT_6	ExVE+EmVE
CTAAGCG_TGAT_6	ExVE+EmVE
TCTGGAG_TGAT_6	ExVE+EmVE
GCCTACA_TGAT_6	ExVE+EmVE
ACGGATA_TCTA_6	ExVE+EmVE
GGTGATC_TCTA_6	ExVE+EmVE
AGCTAGT_TCTA_6	ExVE+EmVE
AACGTTC_TCTA_6	ExVE+EmVE
TACGTAC_TCTA_6	ExVE+EmVE
GGTCTTA_AGTC_7	ExVE+EmVE
TCAGCCT_AGTC_7	ExVE+EmVE
ACGCTTC_AGTC_7	ExVE+EmVE
TGAGCAG_AGTC_7	ExVE+EmVE
TCTTAGG_AGTC_7	ExVE+EmVE
AGCTGTT_AGTC_7	DE+ExVE
CTATTCG_AGTC_7	ExVE+EmVE
GTATGCG_AGTC_7	ExVE+EmVE
TTCAAGC_AGTC_7	ExVE+EmVE
TGGAGCA_AGTC_7	ExVE+EmVE
GCTTCAT_AGTC_7	ExVE+EmVE
CCTGATG_AGTC_7	ExVE+EmVE
ACTCAGG_AGTC_7	ExVE+EmVE
TTCCTGA_AGTC_7	FG+ExVE
GATCACA_AGTC_7	ExVE+EmVE
CTAGTGC_AGTC_7	ExVE+EmVE
ATCAGGC_AGTC_7	FG+ExVE
CTGGAAG_CATG_7	ExVE+EmVE
TATGTCC_CATG_7	ExVE+EmVE
CGGTCTA_CATG_7	ExVE+EmVE
CAAGGTT_CATG_7	ExVE+EmVE
GTATGCG_CATG_7	ExVE+EmVE
CCTGATG_CATG_7	ExVE+EmVE
TTCCTGA_CATG_7	ExVE+EmVE
GGCTAGA_CATG_7	FG+ExVE
GCAGTAG_CATG_7	ExVE+EmVE
AGTACCT_CTAC_13	MG+ExVE
AGCAGGT_CTAC_13	ExVE+EmVE
CGTTGAA_CTAC_13	ExVE+EmVE
GATAGTC_TCTA_16	MG+ExVE
TAGGCAT_TCTA_16	ExVE+EmVE
ATCAGGC_TCTA_16	ExVE+EmVE
ACCGATC_TCTA_16	ExVE+EmVE
CAGTCAA_TCTA_16	MG+ExVE
CTTACGG_TCTA_16	ExVE+EmVE
TCAGCCT_TCTA_23	FG+ExVE
AATGCCG_TCTA_23	ExVE+EmVE
ATCTGCA_TCTA_23	ExVE+EmVE
AACGTTC_CTAC_13	DE+ExVE
CTAAGCG_CTAC_13	MG+ExVE
CTACAAG_CTAC_13	MG+ExVE
AACTCGT_CTAC_13	MG+ExVE
CAGGAAT_ATCA_14	ExVE+EmVE
CGTGCAT_ATCA_14	ExVE+EmVE
GTTACCT_ATCA_14	ExVE+EmVE
TGAGACC_ATCA_14	MG+ExVE
CTGTATG_ATCA_14	DE+ExVE
ACGGATA_ATCA_14	FG+ExVE
CAACATG_ATCA_14	ExVE+EmVE
TTCCTGA_ATCA_14	ExVE+EmVE
GGCTAGA_ATCA_14	ExVE+EmVE
GGATCTA_ATCA_14	MG+ExVE
AGGCGTT_ATCA_14	FG+ExVE
GGAGACT_ATCA_14	MG+ExVE
GCTTAGA_ATCA_14	MG+ExVE
CGTTGAA_ATCA_9	FG+ExVE
GGTTCAA_TGAT_15	MG+ExVE
TACGACT_TGAT_15	MG+ExVE
ATAGCCT_TGAT_15	MG+ExVE
GTCACAC_TGAT_15	MG+ExVE
TGAGCAG_TGAT_15	MG+ExVE
CAACGGT_TGAT_15	MG+ExVE
AGATGCG_TGAT_15	FG+ExVE
CTTGTAC_TGAT_15	ExVE+EmVE
GTAAGTC_TGAT_15	MG+ExVE
ACGGATA_TGAT_15	MG+ExVE
TAGGCAT_TGAT_15	MG+ExVE
GTACGGT_TGAT_15	ExVE+EmVE
GTTGACT_TGAT_15	ExVE+EmVE
CCTAAGG_TGAT_15	MG+ExVE
ACTCAGG_TGAT_15	ExVE+EmVE
TTCCTGA_TGAT_15	MG+ExVE
CGTTGAA_TGAT_15	ExVE+EmVE
CGTCAGA_TGAT_15	MG+ExVE
AGCACTG_TGAT_15	ExVE+EmVE
AAGCCTT_TGAT_15	MG+ExVE
ATCTGTC_TGAT_15	MG+ExVE
AGCCGAT_TGAT_15	MG+ExVE
CTACAGC_TGAT_15	FG+ExVE
GGTTCAA_TTGG_19	MG+ExVE
CAGGAAT_TTGG_19	ExVE+EmVE
ATAGCCT_TTGG_19	ExVE+EmVE
GGTCCAT_TTGG_19	FG+ExVE
ATCTACG_TTGG_19	ExVE+EmVE
TTCCTGA_TTGG_19	DE+ExVE
GACACTG_TTGG_19	MG+ExVE
GCTGAAT_TTGG_19	ExVE+EmVE
CGTTGAA_TTGG_19	ExVE+EmVE
CGGATTA_TTGG_19	FG+ExVE
TCGACTC_TTGG_19	MG+ExVE
CGGTCTA_ACAG_19	ExVE+EmVE
TGCTGAG_ACAG_19	ExVE+EmVE
TTCAGTC_ACAG_19	ExVE+EmVE
TGGACAC_ACAG_19	ExVE+EmVE
CAACGGT_ACAG_19	ExVE+EmVE
ACGATGC_ACAG_19	ExVE+EmVE
CGATATC_ACAG_19	ExVE+EmVE
TCGTGAG_ACAG_19	ExVE+EmVE
CCTGATG_ACAG_19	ExVE+EmVE
ATCTGCA_ACAG_19	ExVE+EmVE
GGCTAGA_ACAG_19	ExVE+EmVE
CAATCGA_ACAG_19	ExVE+EmVE
CACAGAT_ACAG_19	FG+ExVE
ACCGATC_ACAG_19	MG+ExVE
TGCACAA_ACAG_19	ExVE+EmVE
ATAGCGA_ACAG_19	ExVE+EmVE
CTTAAGC_TTGG_19	MG+ExVE
AACAGCT_TTGG_19	FG+ExVE
CGAAGGT_ACAG_19	FG+ExVE
TGAGCAG_AGTC_17	ExVE+EmVE
GTCACAC_CTAC_20	FG+ExVE
CTGGAAG_TCTA_32	MG+ExVE
CAGGAAT_TCTA_32	FG+ExVE
GTCATGC_TCTA_32	FG+ExVE
GCAACTA_TCTA_32	FG+ExVE
CCATGGT_ACAG_35	FG+ExVE
CGGTCTA_ACAG_29	MG+ExVE
GAGATCG_ACAG_29	ExVE+EmVE
CAATCGA_ACAG_29	DE+ExVE
TGACGGA_ACAG_29	ExVE+EmVE
AGCTAGT_TCTA_32	ExVE+EmVE